PtWidget()Photon::Widget
PtNumericFloat()Photon::NumericFloat
PtBasic()Photon::Basic
PtLabel()Photon::Label
PtText()Photon::Text
PtMultiText()Photon::MultiText
PtButton()Photon::Button
PtMenuButton()QMenu
PtOnOffButton()Photon::OnOffButton
PtToggleButton()Photon::ToggleButton
PtContainer()Photon::Container
PtGroup()Photon::Group
PtPane()Photon::Pane
PtScrollArea()QScrollArea
PtBkgd()Photon::Bkgd
PtRegion()QFrame
PtWindow()QMainWindow
PtMenu()QMenu
PtBitmap()Photon::Bitmap
PtGauge()Photon::Gauge
PtSlider()QSlider
PtGenlist()Photon::GenList
PtList()Photon::List
PtGenTree()QTreeWidget
PtTree()QTreeWidget
PtRaw()QFrame
PtGraphic()Photon::Graphic
PtArc()Photon::Arc
PtPolygon()Photon::Polygon
PtRect()Photon::Rect
PtScrollbar()QScrollBar
PtSeparator()Photon::Separator
PtComboBox()Photon::ComboBox
PtCompound()QFrame
PtMenuBar()QMenuBar
PtFontSel()Photon::FontSel
PtTimer()Photon::Timer
PtBezier()Photon::Bezier
PtGrid()Photon::Grid
PtDivider()QSplitter
PtFileSel()Photon::FileSel
PtTerminal()QFrame
PtTty()QFrame
PtUpDown()Photon::UpDown
PtNumeric()Photon::Numeric
PtNumericInteger()Photon::NumericInteger
PtCalendar()Photon::Calendar
PtClock()Photon::Clock
PtTab()Photon::Tab
PtToolbar()QToolBar
PtToolbarGroup()QWidget
PtEllipse()Photon::Ellipse
PtPanelGroup(64004:0)QStackedWidget
PtPanelGroup()QTabWidget
PtDisjoint()QFrame
PtRawList()QListWidget
PtRawTree()QTreeWidget
PtScrollContainer()QScrollArea
PtTrend()Photon::Trend
PtMeter()Photon::Meter
PtMTrend()Photon::MTrend
PtOSContainer()QFrame
PtServer()QFrame
PtClient()QFrame
PtWebClient()QFrame
PtImageArea()Photon::ImageArea
PtColorSel()Photon::ColorSel
PtColorPatch()Photon::ColorPatch
PtColorWell()Photon::ColorWell
PtColorPanel()Photon::ColorPanel
PtColorSelGroup()Photon::ColorSelGroup
PtProgress()Photon::Progress
PtBarGraph()Photon::BarGraph
PtLine()Photon::Line
PtPixel()Photon::Pixel
